...............
..........WWW..
..........WGW..
..........W,W..
..........W,W..
.WWWWWWWWWW,WW.
.W,,,B.,,B,,.W.
.W,WWWWWWWWWWW.
.W,W...........
.W,W...........
.WPW...........
.WWW...........
...............
