..............
..........WWW.
..........WGW.
..........W,W.
..........W,W.
.WWWWWWWWWW,W.
.W,,,,.,,.,,W.
.W,WWWWWWWWWW.
.W,W..........
.W,W..........
.WPW..........
.WWW..........
..............
