...........
.WWWWWWWWW.
.W,,EEEEEW.
.W,,,EEE,W.
.W,WWWWWGW.
.W,W...WWW.
.W,W.......
.W,WWW.....
.W,,.W.....
.WWW,W.....
...W,W.....
.WWW,W.....
.W,,,W.....
.W,BBW.....
.W,,,W.....
.W...W.....
.W,,,W.....
.W1WWW.....
.W,SW......
.W,,W......
.W,WW......
.WPW.......
.WWW.......
...........
