...........
.WWWWWWWWW.
.W,,,,,,GW.
.W,WWWWWWW.
.W.W.......
.W,W.......
.W1WW......
.W,SW......
.W,,W......
.W,WW......
.WPW.......
.WWW.......
...........
